{
  "hierarchies": {
    "type1": {
      "strength": 1.5,
      "nodes": [
        {
          "n00": { "x": 0, "y": 0 },
          "n01": { "x": 0, "y": 1 },
          "n02": { "x": 0, "y": 2 },
          "n03": { "x": 0, "y": 3 },
          "n10": { "x": 1, "y": 0 },
          "n11": { "x": 1, "y": 1 },
          "n12": { "x": 1, "y": 2 },
          "n13": { "x": 1, "y": 3 },
          "n20": { "x": 2, "y": 0 },
          "n21": { "x": 2, "y": 1 },
          "n22": { "x": 2, "y": 2 },
          "n23": { "x": 2, "y": 3 },
          "n30": { "x": 3, "y": 0 },
          "n31": { "x": 3, "y": 1 },
          "n32": { "x": 3, "y": 2 },
          "n33": { "x": 3, "y": 3 }
        }
      ]
    }
  },
  "rules": [["type1", "type1"]]
}
